xxxxxxxxxxxxxxxxxxxxxxxxxxxxxxxxxxxxxxxxxxxxxxxxxxxxxxxxxxxx
x__________________________________________________________x
x__________________________________________________________x
x__________________________________________________________x
x__________________________________________________________x
x_______________________fff________________________________x
x________________________ffffMM____________________________x
x__________________________MMMMfff_________________________x
x__________________MM_______MMMMffff_______________________x
x___________________MM_______MM____________________________x
x____________________MM____MMMM_________________f__________x
x______________________MMMMMMMMMMM_____________fff_________x
x______________________MMMMMMMMMMMM__________fffffff_______x
x____ff_________________MMMMMMMMMMMMMM_________ffffff______x
x_____fff__________________MMMMMMM____MM________fff________x
x______fff___________________MMMMMMM___MM__________________x
x____fffffffff_____________MMMMMM__~~~__MMM________________x
x______fffff________________MMMM__~~~~_____MMMM____________x
x________ff______________MM__MM_M___~_____MM___M___________x
x__________________________MMMMMMMM__~_____M_______________x
x___________________________MMMM__MM__~____________________x
x____________________________MM____MMMM~___________________x
x__________________________MMMM_____MMMMM__________________x
x___________________________MMMM______MM___________________x
x____________________________MM________MM__________________x
x__________________________MMMMMM_______MM_________________x
x____________~______________MMMM_MM________________________x
x___________~~~______________MM____MM______________________x
x_________~~~~~~___________________________________________x
x___________~~~_____________MMM____________________________x
x____________~~~~~___________MM____________________________x
x_____________~~~__________________________________________x
x_____________~~~__________________________________________x
x_______________~__________________________________________x
x__________________________________________________________x
x__________________________________________________________x
x__________________________________________________________x
x__________________________________________________________x
x__________________________________________________________x
xxxxxxxxxxxxxxxxxxxxxxxxxxxxxxxxxxxxxxxxxxxxxxxxxxxxxxxxxxxx
